nn	ん
we	ゑ
wi	ゐ
/a	∧
/o	∨
/e	∃
/u	∀
/b	⇔
/d	∈
/f	∋
/c	々
/r	ゝ
/w	ʬ
/h	←
/t	↑
/n	↓
/s	→
/g	↖
/l	↗
/m	↙
/z	↘
'	っ
-	ー
p	…
y	・
a	あ
la	ぁ
o	お
lo	ぉ
e	え
le	ぇ
u	う
lu	ぅ
i	い
li	ぃ
;	あん
l;	ぁん
q	おん
lq	ぉん
j	えん
lj	ぇん
k	うん
lk	ぅん
x	いん
lx	ぃん
f'	ぱい
f,	ぽう
f.	ぺい
fp	ぷう
fy	ぷい
fa	ぱ
fo	ぽ
fe	ぺ
fu	ぷ
fi	ぴ
f;	ぱん
fq	ぽん
fj	ぺん
fk	ぷん
fx	ぴん
ff	ぴゅう
fl	ぴょう
g'	がい
g,	ごう
g.	げい
gp	ぐう
gy	ぐい
ga	が
go	ご
ge	げ
gu	ぐ
gi	ぎ
g;	がん
gq	ごん
gj	げん
gk	ぐん
gx	ぎん
gf	ぎゅう
gl	ぎょう
c'	かい
lc'	ゕい
c,	こう
c.	けい
lc.	ゖい
cp	くう
cy	くい
ca	か
lca	ゕ
co	こ
ce	け
lce	ゖ
cu	く
ci	き
c;	かん
lc;	ゕん
cq	こん
cj	けん
lcj	ゖん
ck	くん
cx	きん
cf	きゅう
cl	きょう
r'	らい
r,	ろう
r.	れい
rp	るう
ry	るい
ra	ら
ro	ろ
re	れ
ru	る
ri	り
r;	らん
rq	ろん
rj	れん
rk	るん
rx	りん
rf	りゅう
rl	りょう
fr'	ぷぁい
fr,	ぷぉう
fr.	ぷぇい
frp	ぷぅう
fry	ぷぅい
fra	ぷぁ
fro	ぷぉ
fre	ぷぇ
fru	ぷぅ
fri	ぷぃ
fr;	ぷぁん
frq	ぷぉん
frj	ぷぇん
frk	ぷぅん
frx	ぷぃん
frf	ぷぃゅう
frl	ぷぃょう
gr'	ぐぁい
gr,	ぐぉう
gr.	ぐぇい
grp	ぐぅう
gry	ぐぅい
gra	ぐぁ
gro	ぐぉ
gre	ぐぇ
gru	ぐぅ
gri	ぐぃ
gr;	ぐぁん
grq	ぐぉん
grj	ぐぇん
grk	ぐぅん
grx	ぐぃん
grf	ぐぃゅう
grl	ぐぃょう
cr'	くぁい
cr,	くぉう
cr.	くぇい
crp	くぅう
cry	くぅい
cra	くぁ
cro	くぉ
cre	くぇ
cru	くぅ
cri	くぃ
cr;	くぁん
crq	くぉん
crj	くぇん
crk	くぅん
crx	くぃん
crf	くぃゅう
crl	くぃょう
rr'	るぁい
rr,	るぉう
rr.	るぇい
rrp	るぅう
rry	るぅい
rra	るぁ
rro	るぉ
rre	るぇ
rru	るぅ
rri	るぃ
rr;	るぁん
rrq	るぉん
rrj	るぇん
rrk	るぅん
rrx	るぃん
rrf	るぃゅう
rrl	るぃょう
d'	だい
d,	どう
d.	でい
dp	づう
dy	づい
da	だ
do	ど
de	で
du	づ
di	ぢ
d;	だん
dq	どん
dj	でん
dk	づん
dx	ぢん
dd	ぢゅう
ds	ぢょう
h'	はい
h,	ほう
h.	へい
hp	ふう
hy	ふい
ha	は
ho	ほ
he	へ
hu	ふ
hi	ひ
h;	はん
hq	ほん
hj	へん
hk	ふん
hx	ひん
hd	ひゅう
hs	ひょう
t'	たい
t,	とう
t.	てい
tp	つう
ltp	っう
ty	つい
lty	っい
ta	た
to	と
te	て
tu	つ
ltu	っ
ti	ち
t;	たん
tq	とん
tj	てん
tk	つん
ltk	っん
tx	ちん
td	ちゅう
ts	ちょう
n'	ない
n,	のう
n.	ねい
np	ぬう
ny	ぬい
na	な
no	の
ne	ね
nu	ぬ
ni	に
n;	なん
nq	のん
nj	ねん
nk	ぬん
nx	にん
nd	にゅう
ns	にょう
s'	さい
s,	そう
s.	せい
sp	すう
sy	すい
sa	さ
so	そ
se	せ
su	す
si	し
s;	さん
sq	そん
sj	せん
sk	すん
sx	しん
sd	しゅう
ss	しょう
dn'	でぁい
dn,	でぉう
dn.	でぇい
dnp	でぅう
dny	でぅい
dna	でぁ
dno	でぉ
dne	でぇ
dnu	でぅ
dni	でぃ
dn;	でぁん
dnq	でぉん
dnj	でぇん
dnk	でぅん
dnx	でぃん
dnd	でぃゅう
dns	でぃょう
hn'	ふぁい
hn,	ふぉう
hn.	ふぇい
hnp	ふぅう
hny	ふぅい
hna	ふぁ
hno	ふぉ
hne	ふぇ
hnu	ふぅ
hni	ふぃ
hn;	ふぁん
hnq	ふぉん
hnj	ふぇん
hnk	ふぅん
hnx	ふぃん
hnd	ふぃゅう
hns	ふぃょう
tn'	てぁい
tn,	てぉう
tn.	てぇい
tnp	てぅう
tny	てぅい
tna	てぁ
tno	てぉ
tne	てぇ
tnu	てぅ
tni	てぃ
tn;	てぁん
tnq	てぉん
tnj	てぇん
tnk	てぅん
tnx	てぃん
tnd	てぃゅう
tns	てぃょう
sn'	すぁい
sn,	すぉう
sn.	すぇい
snp	すぅう
sny	すぅい
sna	すぁ
sno	すぉ
sne	すぇ
snu	すぅ
sni	すぃ
sn;	すぁん
snq	すぉん
snj	すぇん
snk	すぅん
snx	すぃん
snd	すぃゅう
sns	すぃょう
b'	ばい
b,	ぼう
b.	べい
bp	ぶう
by	ぶい
ba	ば
bo	ぼ
be	べ
bu	ぶ
bi	び
b;	ばん
bq	ぼん
bj	べん
bk	ぶん
bx	びん
bb	びゅう
bz	びょう
m'	まい
m,	もう
m.	めい
mp	むう
my	むい
ma	ま
mo	も
me	め
mu	む
mi	み
m;	まん
mq	もん
mj	めん
mk	むん
mx	みん
mb	みゅう
mz	みょう
w'	わい
lw'	ゎい
w,	をう
w.	うぇい
wa	わ
lwa	ゎ
wo	を
w;	わん
lw;	ゎん
wq	をん
wj	うぇん
wx	うぃん
wb	うぃゅう
wz	うぃょう
v'	やい
lv'	ゃい
v,	よう
lv,	ょう
vp	ゆう
lvp	ゅう
vy	ゆい
lvy	ゅい
va	や
lva	ゃ
vo	よ
lvo	ょ
vu	ゆ
lvu	ゅ
v;	やん
lv;	ゃん
vq	よん
lvq	ょん
vk	ゆん
lvk	ゅん
z'	ざい
z,	ぞう
z.	ぜい
zp	ずう
zy	ずい
za	ざ
zo	ぞ
ze	ぜ
zu	ず
zi	じ
z;	ざん
zq	ぞん
zj	ぜん
zk	ずん
zx	じん
zb	じゅう
zz	じょう
bv'	ぶぁい
bv,	ぶぉう
bv.	ぶぇい
bvp	ぶぅう
bvy	ぶぅい
bva	ぶぁ
bvo	ぶぉ
bve	ぶぇ
bvu	ぶぅ
bvi	ぶぃ
bv;	ぶぁん
bvq	ぶぉん
bvj	ぶぇん
bvk	ぶぅん
bvx	ぶぃん
bvb	ぶぃゅう
bvz	ぶぃょう
mv'	むぁい
mv,	むぉう
mv.	むぇい
mvp	むぅう
mvy	むぅい
mva	むぁ
mvo	むぉ
mve	むぇ
mvu	むぅ
mvi	むぃ
mv;	むぁん
mvq	むぉん
mvj	むぇん
mvk	むぅん
mvx	むぃん
mvb	むぃゅう
mvz	むぃょう
vv'	ゔぁい
vv,	ゔぉう
vv.	ゔぇい
vvp	ゔう
vvy	ゔい
vva	ゔぁ
vvo	ゔぉ
vve	ゔぇ
vvu	ゔ
vvi	ゔぃ
vv;	ゔぁん
vvq	ゔぉん
vvj	ゔぇん
vvk	ゔん
vvx	ゔぃん
vvb	ゔぃゅう
vvz	ゔぃょう
wv'	うぁい
lwv'	ぅぁい
wv,	うぉう
lwv,	ぅぉう
wv.	うぇい
lwv.	ぅぇい
wvp	うぅう
lwvp	ぅぅう
wvy	うぅい
lwvy	ぅぅい
wva	うぁ
lwva	ぅぁ
wvo	うぉ
lwvo	ぅぉ
wve	うぇ
lwve	ぅぇ
wvu	うぅ
lwvu	ぅぅ
wvi	うぃ
lwvi	ぅぃ
wv;	うぁん
lwv;	ぅぁん
wvq	うぉん
lwvq	ぅぉん
wvj	うぇん
lwvj	ぅぇん
wvk	うぅん
lwvk	ぅぅん
wvx	うぃん
lwvx	ぅぃん
wvb	うぃゅう
lwvb	ぅぃゅう
wvz	うぃょう
lwvz	ぅぃょう
zv'	ずぁい
zv,	ずぉう
zv.	ずぇい
zvp	ずぅう
zvy	ずぅい
zva	ずぁ
zvo	ずぉ
zve	ずぇ
zvu	ずぅ
zvi	ずぃ
zv;	ずぁん
zvq	ずぉん
zvj	ずぇん
zvk	ずぅん
zvx	ずぃん
zvb	ずぃゅう
zvz	ずぃょう
fc'	ぴゃい
fc,	ぴょう
fc.	ぴぇい
fcp	ぴゅう
fcy	ぴゅい
fca	ぴゃ
fco	ぴょ
fce	ぴぇ
fcu	ぴゅ
fci	ぴぃ
fc;	ぴゃん
fcq	ぴょん
fcj	ぴぇん
fck	ぴゅん
fcx	ぴぃん
fcf	ぴゃつ
fcg	ぴゃく
fcc	ぴょく
fcr	ぴゅく
fcl	ぴゅつ
gc'	ぎゃい
gc,	ぎょう
gc.	ぎぇい
gcp	ぎゅう
gcy	ぎゅい
gca	ぎゃ
gco	ぎょ
gce	ぎぇ
gcu	ぎゅ
gci	ぎぃ
gc;	ぎゃん
gcq	ぎょん
gcj	ぎぇん
gck	ぎゅん
gcx	ぎぃん
gcf	ぎゃつ
gcg	ぎゃく
gcc	ぎょく
gcr	ぎゅく
gcl	ぎゅつ
cc'	きゃい
cc,	きょう
cc.	きぇい
ccp	きゅう
ccy	きゅい
cca	きゃ
cco	きょ
cce	きぇ
ccu	きゅ
cci	きぃ
cc;	きゃん
ccq	きょん
ccj	きぇん
cck	きゅん
ccx	きぃん
ccf	きゃつ
ccg	きゃく
ccc	きょく
ccr	きゅく
ccl	きゅつ
rc'	りゃい
rc,	りょう
rc.	りぇい
rcp	りゅう
rcy	りゅい
rca	りゃ
rco	りょ
rce	りぇ
rcu	りゅ
rci	りぃ
rc;	りゃん
rcq	りょん
rcj	りぇん
rck	りゅん
rcx	りぃん
rcf	りゃつ
rcg	りゃく
rcc	りょく
rcr	りゅく
rcl	りゅつ
frc'	ぷぃゃい
frc,	ぷぃょう
frc.	ぷぃぇい
frcp	ぷぃゅう
frcy	ぷぃゅい
frca	ぷぃゃ
frco	ぷぃょ
frce	ぷぃぇ
frcu	ぷぃゅ
frci	ぷぃぃ
frc;	ぷぃゃん
frcq	ぷぃょん
frcj	ぷぃぇん
frck	ぷぃゅん
frcx	ぷぃぃん
frcf	ぷぃゃつ
frcg	ぷぃゃく
frcc	ぷぃょく
frcr	ぷぃゅく
frcl	ぷぃゅつ
grc'	ぐぃゃい
grc,	ぐぃょう
grc.	ぐぃぇい
grcp	ぐぃゅう
grcy	ぐぃゅい
grca	ぐぃゃ
grco	ぐぃょ
grce	ぐぃぇ
grcu	ぐぃゅ
grci	ぐぃぃ
grc;	ぐぃゃん
grcq	ぐぃょん
grcj	ぐぃぇん
grck	ぐぃゅん
grcx	ぐぃぃん
grcf	ぐぃゃつ
grcg	ぐぃゃく
grcc	ぐぃょく
grcr	ぐぃゅく
grcl	ぐぃゅつ
crc'	くぃゃい
crc,	くぃょう
crc.	くぃぇい
crcp	くぃゅう
crcy	くぃゅい
crca	くぃゃ
crco	くぃょ
crce	くぃぇ
crcu	くぃゅ
crci	くぃぃ
crc;	くぃゃん
crcq	くぃょん
crcj	くぃぇん
crck	くぃゅん
crcx	くぃぃん
crcf	くぃゃつ
crcg	くぃゃく
crcc	くぃょく
crcr	くぃゅく
crcl	くぃゅつ
rrc'	るぃゃい
rrc,	るぃょう
rrc.	るぃぇい
rrcp	るぃゅう
rrcy	るぃゅい
rrca	るぃゃ
rrco	るぃょ
rrce	るぃぇ
rrcu	るぃゅ
rrci	るぃぃ
rrc;	るぃゃん
rrcq	るぃょん
rrcj	るぃぇん
rrck	るぃゅん
rrcx	るぃぃん
rrcf	るぃゃつ
rrcg	るぃゃく
rrcc	るぃょく
rrcr	るぃゅく
rrcl	るぃゅつ
dt'	ぢゃい
dt,	ぢょう
dt.	ぢぇい
dtp	ぢゅう
dty	ぢゅい
dta	ぢゃ
dto	ぢょ
dte	ぢぇ
dtu	ぢゅ
dti	ぢぃ
dt;	ぢゃん
dtq	ぢょん
dtj	ぢぇん
dtk	ぢゅん
dtx	ぢぃん
dtd	ぢゃつ
dth	ぢゃく
dtt	ぢょく
dtn	ぢゅく
dts	ぢゅつ
ht'	ひゃい
ht,	ひょう
ht.	ひぇい
htp	ひゅう
hty	ひゅい
hta	ひゃ
hto	ひょ
hte	ひぇ
htu	ひゅ
hti	ひぃ
ht;	ひゃん
htq	ひょん
htj	ひぇん
htk	ひゅん
htx	ひぃん
htd	ひゃつ
hth	ひゃく
htt	ひょく
htn	ひゅく
hts	ひゅつ
tt'	ちゃい
tt,	ちょう
tt.	ちぇい
ttp	ちゅう
tty	ちゅい
tta	ちゃ
tto	ちょ
tte	ちぇ
ttu	ちゅ
tti	ちぃ
tt;	ちゃん
ttq	ちょん
ttj	ちぇん
ttk	ちゅん
ttx	ちぃん
ttd	ちゃつ
tth	ちゃく
ttt	ちょく
ttn	ちゅく
tts	ちゅつ
nt'	にゃい
nt,	にょう
nt.	にぇい
ntp	にゅう
nty	にゅい
nta	にゃ
nto	にょ
nte	にぇ
ntu	にゅ
nti	にぃ
nt;	にゃん
ntq	にょん
ntj	にぇん
ntk	にゅん
ntx	にぃん
ntd	にゃつ
nth	にゃく
ntt	にょく
ntn	にゅく
nts	にゅつ
st'	しゃい
st,	しょう
st.	しぇい
stp	しゅう
sty	しゅい
sta	しゃ
sto	しょ
ste	しぇ
stu	しゅ
sti	しぃ
st;	しゃん
stq	しょん
stj	しぇん
stk	しゅん
stx	しぃん
std	しゃつ
sth	しゃく
stt	しょく
stn	しゅく
sts	しゅつ
dnt'	でぃゃい
dnt,	でぃょう
dnt.	でぃぇい
dntp	でぃゅう
dnty	でぃゅい
dnta	でぃゃ
dnto	でぃょ
dnte	でぃぇ
dntu	でぃゅ
dnti	でぃぃ
dnt;	でぃゃん
dntq	でぃょん
dntj	でぃぇん
dntk	でぃゅん
dntx	でぃぃん
dntd	でぃゃつ
dnth	でぃゃく
dntt	でぃょく
dntn	でぃゅく
dnts	でぃゅつ
hnt'	ふぃゃい
hnt,	ふぃょう
hnt.	ふぃぇい
hntp	ふぃゅう
hnty	ふぃゅい
hnta	ふぃゃ
hnto	ふぃょ
hnte	ふぃぇ
hntu	ふぃゅ
hnti	ふぃぃ
hnt;	ふぃゃん
hntq	ふぃょん
hntj	ふぃぇん
hntk	ふぃゅん
hntx	ふぃぃん
hntd	ふぃゃつ
hnth	ふぃゃく
hntt	ふぃょく
hntn	ふぃゅく
hnts	ふぃゅつ
tnt'	てぃゃい
tnt,	てぃょう
tnt.	てぃぇい
tntp	てぃゅう
tnty	てぃゅい
tnta	てぃゃ
tnto	てぃょ
tnte	てぃぇ
tntu	てぃゅ
tnti	てぃぃ
tnt;	てぃゃん
tntq	てぃょん
tntj	てぃぇん
tntk	てぃゅん
tntx	てぃぃん
tntd	てぃゃつ
tnth	てぃゃく
tntt	てぃょく
tntn	てぃゅく
tnts	てぃゅつ
snt'	すぃゃい
snt,	すぃょう
snt.	すぃぇい
sntp	すぃゅう
snty	すぃゅい
snta	すぃゃ
snto	すぃょ
snte	すぃぇ
sntu	すぃゅ
snti	すぃぃ
snt;	すぃゃん
sntq	すぃょん
sntj	すぃぇん
sntk	すぃゅん
sntx	すぃぃん
sntd	すぃゃつ
snth	すぃゃく
sntt	すぃょく
sntn	すぃゅく
snts	すぃゅつ
bw'	びゃい
bw,	びょう
bw.	びぇい
bwp	びゅう
bwy	びゅい
bwa	びゃ
bwo	びょ
bwe	びぇ
bwu	びゅ
bwi	びぃ
bw;	びゃん
bwq	びょん
bwj	びぇん
bwk	びゅん
bwx	びぃん
bwb	びゃつ
bwm	びゃく
bww	びょく
bwv	びゅく
bwz	びゅつ
mw'	みゃい
mw,	みょう
mw.	みぇい
mwp	みゅう
mwy	みゅい
mwa	みゃ
mwo	みょ
mwe	みぇ
mwu	みゅ
mwi	みぃ
mw;	みゃん
mwq	みょん
mwj	みぇん
mwk	みゅん
mwx	みぃん
mwb	みゃつ
mwm	みゃく
mww	みょく
mwv	みゅく
mwz	みゅつ
zw'	じゃい
zw,	じょう
zw.	じぇい
zwp	じゅう
zwy	じゅい
zwa	じゃ
zwo	じょ
zwe	じぇ
zwu	じゅ
zwi	じぃ
zw;	じゃん
zwq	じょん
zwj	じぇん
zwk	じゅん
zwx	じぃん
zwb	じゃつ
zwm	じゃく
zww	じょく
zwv	じゅく
zwz	じゅつ
bvw'	ぶぃゃい
bvw,	ぶぃょう
bvw.	ぶぃぇい
bvwp	ぶぃゅう
bvwy	ぶぃゅい
bvwa	ぶぃゃ
bvwo	ぶぃょ
bvwe	ぶぃぇ
bvwu	ぶぃゅ
bvwi	ぶぃぃ
bvw;	ぶぃゃん
bvwq	ぶぃょん
bvwj	ぶぃぇん
bvwk	ぶぃゅん
bvwx	ぶぃぃん
bvwb	ぶぃゃつ
bvwm	ぶぃゃく
bvww	ぶぃょく
bvwv	ぶぃゅく
bvwz	ぶぃゅつ
mvw'	むぃゃい
mvw,	むぃょう
mvw.	むぃぇい
mvwp	むぃゅう
mvwy	むぃゅい
mvwa	むぃゃ
mvwo	むぃょ
mvwe	むぃぇ
mvwu	むぃゅ
mvwi	むぃぃ
mvw;	むぃゃん
mvwq	むぃょん
mvwj	むぃぇん
mvwk	むぃゅん
mvwx	むぃぃん
mvwb	むぃゃつ
mvwm	むぃゃく
mvww	むぃょく
mvwv	むぃゅく
mvwz	むぃゅつ
vvw'	ゔぃゃい
vvw,	ゔぃょう
vvw.	ゔぃぇい
vvwp	ゔぃゅう
vvwy	ゔぃゅい
vvwa	ゔぃゃ
vvwo	ゔぃょ
vvwe	ゔぃぇ
vvwu	ゔぃゅ
vvwi	ゔぃぃ
vvw;	ゔぃゃん
vvwq	ゔぃょん
vvwj	ゔぃぇん
vvwk	ゔぃゅん
vvwx	ゔぃぃん
vvwb	ゔぃゃつ
vvwm	ゔぃゃく
vvww	ゔぃょく
vvwv	ゔぃゅく
vvwz	ゔぃゅつ
wvw'	うぃゃい
lwvw'	ぅぃゃい
wvw,	うぃょう
lwvw,	ぅぃょう
wvw.	うぃぇい
lwvw.	ぅぃぇい
wvwp	うぃゅう
lwvwp	ぅぃゅう
wvwy	うぃゅい
lwvwy	ぅぃゅい
wvwa	うぃゃ
lwvwa	ぅぃゃ
wvwo	うぃょ
lwvwo	ぅぃょ
wvwe	うぃぇ
lwvwe	ぅぃぇ
wvwu	うぃゅ
lwvwu	ぅぃゅ
wvwi	うぃぃ
lwvwi	ぅぃぃ
wvw;	うぃゃん
lwvw;	ぅぃゃん
wvwq	うぃょん
lwvwq	ぅぃょん
wvwj	うぃぇん
lwvwj	ぅぃぇん
wvwk	うぃゅん
lwvwk	ぅぃゅん
wvwx	うぃぃん
lwvwx	ぅぃぃん
wvwb	うぃゃつ
lwvwb	ぅぃゃつ
wvwm	うぃゃく
lwvwm	ぅぃゃく
wvww	うぃょく
lwvww	ぅぃょく
wvwv	うぃゅく
lwvwv	ぅぃゅく
wvwz	うぃゅつ
lwvwz	ぅぃゅつ
zvw'	ずぃゃい
zvw,	ずぃょう
zvw.	ずぃぇい
zvwp	ずぃゅう
zvwy	ずぃゅい
zvwa	ずぃゃ
zvwo	ずぃょ
zvwe	ずぃぇ
zvwu	ずぃゅ
zvwi	ずぃぃ
zvw;	ずぃゃん
zvwq	ずぃょん
zvwj	ずぃぇん
zvwk	ずぃゅん
zvwx	ずぃぃん
zvwb	ずぃゃつ
zvwm	ずぃゃく
zvww	ずぃょく
zvwv	ずぃゅく
zvwz	ずぃゅつ
fg'	ぴゃっ
fg,	ぴょっ
fg.	ぴぇっ
fgp	ぴゅっ
fgy	ぴぃっ
fga	ぱっ
fgo	ぽっ
fge	ぺっ
fgu	ぷっ
fgi	ぴっ
fg;	ぱんっ
fgq	ぽんっ
fgj	ぺんっ
fgk	ぷんっ
fgx	ぴんっ
gg'	ぎゃっ
gg,	ぎょっ
gg.	ぎぇっ
ggp	ぎゅっ
ggy	ぎぃっ
gga	がっ
ggo	ごっ
gge	げっ
ggu	ぐっ
ggi	ぎっ
gg;	がんっ
ggq	ごんっ
ggj	げんっ
ggk	ぐんっ
ggx	ぎんっ
cg'	きゃっ
cg,	きょっ
cg.	きぇっ
cgp	きゅっ
cgy	きぃっ
cga	かっ
lcga	ゕっ
cgo	こっ
cge	けっ
lcge	ゖっ
cgu	くっ
cgi	きっ
cg;	かんっ
lcg;	ゕんっ
cgq	こんっ
cgj	けんっ
lcgj	ゖんっ
cgk	くんっ
cgx	きんっ
rg'	りゃっ
rg,	りょっ
rg.	りぇっ
rgp	りゅっ
rgy	りぃっ
rga	らっ
rgo	ろっ
rge	れっ
rgu	るっ
rgi	りっ
rg;	らんっ
rgq	ろんっ
rgj	れんっ
rgk	るんっ
rgx	りんっ
frg'	ぷぃゃっ
frg,	ぷぃょっ
frg.	ぷぃぇっ
frgp	ぷぃゅっ
frgy	ぷぃぃっ
frga	ぷぁっ
frgo	ぷぉっ
frge	ぷぇっ
frgu	ぷぅっ
frgi	ぷぃっ
frg;	ぷぁんっ
frgq	ぷぉんっ
frgj	ぷぇんっ
frgk	ぷぅんっ
frgx	ぷぃんっ
grg'	ぐぃゃっ
grg,	ぐぃょっ
grg.	ぐぃぇっ
grgp	ぐぃゅっ
grgy	ぐぃぃっ
grga	ぐぁっ
grgo	ぐぉっ
grge	ぐぇっ
grgu	ぐぅっ
grgi	ぐぃっ
grg;	ぐぁんっ
grgq	ぐぉんっ
grgj	ぐぇんっ
grgk	ぐぅんっ
grgx	ぐぃんっ
crg'	くぃゃっ
crg,	くぃょっ
crg.	くぃぇっ
crgp	くぃゅっ
crgy	くぃぃっ
crga	くぁっ
crgo	くぉっ
crge	くぇっ
crgu	くぅっ
crgi	くぃっ
crg;	くぁんっ
crgq	くぉんっ
crgj	くぇんっ
crgk	くぅんっ
crgx	くぃんっ
rrg'	るぃゃっ
rrg,	るぃょっ
rrg.	るぃぇっ
rrgp	るぃゅっ
rrgy	るぃぃっ
rrga	るぁっ
rrgo	るぉっ
rrge	るぇっ
rrgu	るぅっ
rrgi	るぃっ
rrg;	るぁんっ
rrgq	るぉんっ
rrgj	るぇんっ
rrgk	るぅんっ
rrgx	るぃんっ
dh'	ぢゃっ
dh,	ぢょっ
dh.	ぢぇっ
dhp	ぢゅっ
dhy	ぢぃっ
dha	だっ
dho	どっ
dhe	でっ
dhu	づっ
dhi	ぢっ
dh;	だんっ
dhq	どんっ
dhj	でんっ
dhk	づんっ
dhx	ぢんっ
hh'	ひゃっ
hh,	ひょっ
hh.	ひぇっ
hhp	ひゅっ
hhy	ひぃっ
hha	はっ
hho	ほっ
hhe	へっ
hhu	ふっ
hhi	ひっ
hh;	はんっ
hhq	ほんっ
hhj	へんっ
hhk	ふんっ
hhx	ひんっ
th'	ちゃっ
th,	ちょっ
th.	ちぇっ
thp	ちゅっ
thy	ちぃっ
tha	たっ
tho	とっ
the	てっ
thu	つっ
lthu	っっ
thi	ちっ
th;	たんっ
thq	とんっ
thj	てんっ
thk	つんっ
lthk	っんっ
thx	ちんっ
nh'	にゃっ
nh,	にょっ
nh.	にぇっ
nhp	にゅっ
nhy	にぃっ
nha	なっ
nho	のっ
nhe	ねっ
nhu	ぬっ
nhi	にっ
nh;	なんっ
nhq	のんっ
nhj	ねんっ
nhk	ぬんっ
nhx	にんっ
sh'	しゃっ
sh,	しょっ
sh.	しぇっ
shp	しゅっ
shy	しぃっ
sha	さっ
sho	そっ
she	せっ
shu	すっ
shi	しっ
sh;	さんっ
shq	そんっ
shj	せんっ
shk	すんっ
shx	しんっ
dnh'	でぃゃっ
dnh,	でぃょっ
dnh.	でぃぇっ
dnhp	でぃゅっ
dnhy	でぃぃっ
dnha	でぁっ
dnho	でぉっ
dnhe	でぇっ
dnhu	でぅっ
dnhi	でぃっ
dnh;	でぁんっ
dnhq	でぉんっ
dnhj	でぇんっ
dnhk	でぅんっ
dnhx	でぃんっ
hnh'	ふぃゃっ
hnh,	ふぃょっ
hnh.	ふぃぇっ
hnhp	ふぃゅっ
hnhy	ふぃぃっ
hnha	ふぁっ
hnho	ふぉっ
hnhe	ふぇっ
hnhu	ふぅっ
hnhi	ふぃっ
hnh;	ふぁんっ
hnhq	ふぉんっ
hnhj	ふぇんっ
hnhk	ふぅんっ
hnhx	ふぃんっ
tnh'	てぃゃっ
tnh,	てぃょっ
tnh.	てぃぇっ
tnhp	てぃゅっ
tnhy	てぃぃっ
tnha	てぁっ
tnho	てぉっ
tnhe	てぇっ
tnhu	てぅっ
tnhi	てぃっ
tnh;	てぁんっ
tnhq	てぉんっ
tnhj	てぇんっ
tnhk	てぅんっ
tnhx	てぃんっ
snh'	すぃゃっ
snh,	すぃょっ
snh.	すぃぇっ
snhp	すぃゅっ
snhy	すぃぃっ
snha	すぁっ
snho	すぉっ
snhe	すぇっ
snhu	すぅっ
snhi	すぃっ
snh;	すぁんっ
snhq	すぉんっ
snhj	すぇんっ
snhk	すぅんっ
snhx	すぃんっ
bm'	びゃっ
bm,	びょっ
bm.	びぇっ
bmp	びゅっ
bmy	びぃっ
bma	ばっ
bmo	ぼっ
bme	べっ
bmu	ぶっ
bmi	びっ
bm;	ばんっ
bmq	ぼんっ
bmj	べんっ
bmk	ぶんっ
bmx	びんっ
mm'	みゃっ
mm,	みょっ
mm.	みぇっ
mmp	みゅっ
mmy	みぃっ
mma	まっ
mmo	もっ
mme	めっ
mmu	むっ
mmi	みっ
mm;	まんっ
mmq	もんっ
mmj	めんっ
mmk	むんっ
mmx	みんっ
wm'	うぃゃっ
wm,	うぃょっ
wm.	うぃぇっ
wmp	うぃゅっ
wmy	うぃぃっ
wma	わっ
lwma	ゎっ
wmo	をっ
wme	うぇっ
wmi	うぃっ
wm;	わんっ
lwm;	ゎんっ
wmq	をんっ
wmj	うぇんっ
wmx	うぃんっ
vma	やっ
lvma	ゃっ
vmo	よっ
lvmo	ょっ
vmu	ゆっ
lvmu	ゅっ
vm;	やんっ
lvm;	ゃんっ
vmq	よんっ
lvmq	ょんっ
vmk	ゆんっ
lvmk	ゅんっ
zm'	じゃっ
zm,	じょっ
zm.	じぇっ
zmp	じゅっ
zmy	じぃっ
zma	ざっ
zmo	ぞっ
zme	ぜっ
zmu	ずっ
zmi	じっ
zm;	ざんっ
zmq	ぞんっ
zmj	ぜんっ
zmk	ずんっ
zmx	じんっ
bvm'	ぶぃゃっ
bvm,	ぶぃょっ
bvm.	ぶぃぇっ
bvmp	ぶぃゅっ
bvmy	ぶぃぃっ
bvma	ぶぁっ
bvmo	ぶぉっ
bvme	ぶぇっ
bvmu	ぶぅっ
bvmi	ぶぃっ
bvm;	ぶぁんっ
bvmq	ぶぉんっ
bvmj	ぶぇんっ
bvmk	ぶぅんっ
bvmx	ぶぃんっ
mvm'	むぃゃっ
mvm,	むぃょっ
mvm.	むぃぇっ
mvmp	むぃゅっ
mvmy	むぃぃっ
mvma	むぁっ
mvmo	むぉっ
mvme	むぇっ
mvmu	むぅっ
mvmi	むぃっ
mvm;	むぁんっ
mvmq	むぉんっ
mvmj	むぇんっ
mvmk	むぅんっ
mvmx	むぃんっ
vvm'	ゔぃゃっ
vvm,	ゔぃょっ
vvm.	ゔぃぇっ
vvmp	ゔぃゅっ
vvmy	ゔぃぃっ
vvma	ゔぁっ
vvmo	ゔぉっ
vvme	ゔぇっ
vvmu	ゔっ
vvmi	ゔぃっ
vvm;	ゔぁんっ
vvmq	ゔぉんっ
vvmj	ゔぇんっ
vvmk	ゔんっ
vvmx	ゔぃんっ
wvm'	うぃゃっ
lwvm'	ぅぃゃっ
wvm,	うぃょっ
lwvm,	ぅぃょっ
wvm.	うぃぇっ
lwvm.	ぅぃぇっ
wvmp	うぃゅっ
lwvmp	ぅぃゅっ
wvmy	うぃぃっ
lwvmy	ぅぃぃっ
wvma	うぁっ
lwvma	ぅぁっ
wvmo	うぉっ
lwvmo	ぅぉっ
wvme	うぇっ
lwvme	ぅぇっ
wvmu	うぅっ
lwvmu	ぅぅっ
wvmi	うぃっ
lwvmi	ぅぃっ
wvm;	うぁんっ
lwvm;	ぅぁんっ
wvmq	うぉんっ
lwvmq	ぅぉんっ
wvmj	うぇんっ
lwvmj	ぅぇんっ
wvmk	うぅんっ
lwvmk	ぅぅんっ
wvmx	うぃんっ
lwvmx	ぅぃんっ
zvm'	ずぃゃっ
zvm,	ずぃょっ
zvm.	ずぃぇっ
zvmp	ずぃゅっ
zvmy	ずぃぃっ
zvma	ずぁっ
zvmo	ずぉっ
zvme	ずぇっ
zvmu	ずぅっ
zvmi	ずぃっ
zvm;	ずぁんっ
zvmq	ずぉんっ
zvmj	ずぇんっ
zvmk	ずぅんっ
zvmx	ずぃんっ
